"","Id","Id2","Geography","Estimate; Total:","Estimate; Native:","Estimate; Native: - Allocated","Estimate; Native: - Not allocated","Estimate; Foreign born:","Estimate; Foreign born: - Allocated","Estimate; Foreign born: - Not allocated"
"1","1500000US080310001021","080310001021","Block Group 1, Census Tract 1.02, Denver County, Colorado",981,929,90,839,52,0,52
"2","1500000US080310001022","080310001022","Block Group 2, Census Tract 1.02, Denver County, Colorado",1475,1378,85,1293,97,7,90
"3","1500000US080310001023","080310001023","Block Group 3, Census Tract 1.02, Denver County, Colorado",816,799,28,771,17,0,17
"4","1500000US080310002011","080310002011","Block Group 1, Census Tract 2.01, Denver County, Colorado",1722,1488,96,1392,234,0,234
"5","1500000US080310002012","080310002012","Block Group 2, Census Tract 2.01, Denver County, Colorado",2360,1787,208,1579,573,90,483
"6","1500000US080310002021","080310002021","Block Group 1, Census Tract 2.02, Denver County, Colorado",593,522,0,522,71,0,71
"7","1500000US080310002022","080310002022","Block Group 2, Census Tract 2.02, Denver County, Colorado",1534,1377,114,1263,157,10,147
"8","1500000US080310002023","080310002023","Block Group 3, Census Tract 2.02, Denver County, Colorado",840,773,26,747,67,0,67
"9","1500000US080310002024","080310002024","Block Group 4, Census Tract 2.02, Denver County, Colorado",1029,959,56,903,70,0,70
"10","1500000US080310003011","080310003011","Block Group 1, Census Tract 3.01, Denver County, Colorado",787,717,83,634,70,19,51
"11","1500000US080310003012","080310003012","Block Group 2, Census Tract 3.01, Denver County, Colorado",716,676,29,647,40,0,40
"12","1500000US080310003013","080310003013","Block Group 3, Census Tract 3.01, Denver County, Colorado",1042,998,21,977,44,2,42
"13","1500000US080310003014","080310003014","Block Group 4, Census Tract 3.01, Denver County, Colorado",1373,1215,78,1137,158,0,158
"14","1500000US080310003015","080310003015","Block Group 5, Census Tract 3.01, Denver County, Colorado",733,636,18,618,97,0,97
"15","1500000US080310003016","080310003016","Block Group 6, Census Tract 3.01, Denver County, Colorado",814,814,0,814,0,0,0
"16","1500000US080310003021","080310003021","Block Group 1, Census Tract 3.02, Denver County, Colorado",729,729,0,729,0,0,0
"17","1500000US080310003022","080310003022","Block Group 2, Census Tract 3.02, Denver County, Colorado",842,842,21,821,0,0,0
"18","1500000US080310003023","080310003023","Block Group 3, Census Tract 3.02, Denver County, Colorado",823,801,18,783,22,0,22
"19","1500000US080310003024","080310003024","Block Group 4, Census Tract 3.02, Denver County, Colorado",551,537,0,537,14,0,14
"20","1500000US080310003025","080310003025","Block Group 5, Census Tract 3.02, Denver County, Colorado",1468,1366,21,1345,102,0,102
"21","1500000US080310003031","080310003031","Block Group 1, Census Tract 3.03, Denver County, Colorado",678,542,75,467,136,0,136
"22","1500000US080310003032","080310003032","Block Group 2, Census Tract 3.03, Denver County, Colorado",922,898,84,814,24,0,24
"23","1500000US080310003033","080310003033","Block Group 3, Census Tract 3.03, Denver County, Colorado",1154,1045,93,952,109,0,109
"24","1500000US080310003034","080310003034","Block Group 4, Census Tract 3.03, Denver County, Colorado",637,637,0,637,0,0,0
"25","1500000US080310003035","080310003035","Block Group 5, Census Tract 3.03, Denver County, Colorado",801,763,233,530,38,0,38
"26","1500000US080310003036","080310003036","Block Group 6, Census Tract 3.03, Denver County, Colorado",745,691,0,691,54,0,54
"27","1500000US080310004011","080310004011","Block Group 1, Census Tract 4.01, Denver County, Colorado",792,641,0,641,151,0,151
"28","1500000US080310004012","080310004012","Block Group 2, Census Tract 4.01, Denver County, Colorado",784,724,68,656,60,17,43
"29","1500000US080310004013","080310004013","Block Group 3, Census Tract 4.01, Denver County, Colorado",816,736,68,668,80,0,80
"30","1500000US080310004014","080310004014","Block Group 4, Census Tract 4.01, Denver County, Colorado",845,807,30,777,38,8,30
"31","1500000US080310004021","080310004021","Block Group 1, Census Tract 4.02, Denver County, Colorado",435,435,11,424,0,0,0
"32","1500000US080310004022","080310004022","Block Group 2, Census Tract 4.02, Denver County, Colorado",1468,1411,99,1312,57,0,57
"33","1500000US080310004023","080310004023","Block Group 3, Census Tract 4.02, Denver County, Colorado",1258,1076,65,1011,182,0,182
"34","1500000US080310004024","080310004024","Block Group 4, Census Tract 4.02, Denver County, Colorado",642,491,34,457,151,0,151
"35","1500000US080310004025","080310004025","Block Group 5, Census Tract 4.02, Denver County, Colorado",768,671,43,628,97,0,97
"36","1500000US080310004026","080310004026","Block Group 6, Census Tract 4.02, Denver County, Colorado",377,377,0,377,0,0,0
"37","1500000US080310005011","080310005011","Block Group 1, Census Tract 5.01, Denver County, Colorado",1122,1079,88,991,43,7,36
"38","1500000US080310005012","080310005012","Block Group 2, Census Tract 5.01, Denver County, Colorado",812,759,52,707,53,0,53
"39","1500000US080310005021","080310005021","Block Group 1, Census Tract 5.02, Denver County, Colorado",1184,1173,140,1033,11,0,11
"40","1500000US080310005022","080310005022","Block Group 2, Census Tract 5.02, Denver County, Colorado",1537,1451,53,1398,86,0,86
"41","1500000US080310005023","080310005023","Block Group 3, Census Tract 5.02, Denver County, Colorado",940,890,61,829,50,0,50
"42","1500000US080310005024","080310005024","Block Group 4, Census Tract 5.02, Denver County, Colorado",1447,1292,52,1240,155,14,141
"43","1500000US080310005025","080310005025","Block Group 5, Census Tract 5.02, Denver County, Colorado",869,785,10,775,84,0,84
"44","1500000US080310006001","080310006001","Block Group 1, Census Tract 6, Denver County, Colorado",1268,1079,37,1042,189,0,189
"45","1500000US080310006002","080310006002","Block Group 2, Census Tract 6, Denver County, Colorado",1705,1121,48,1073,584,10,574
"46","1500000US080310007011","080310007011","Block Group 1, Census Tract 7.01, Denver County, Colorado",1387,1193,41,1152,194,26,168
"47","1500000US080310007012","080310007012","Block Group 2, Census Tract 7.01, Denver County, Colorado",1157,935,86,849,222,8,214
"48","1500000US080310007013","080310007013","Block Group 3, Census Tract 7.01, Denver County, Colorado",1362,1163,236,927,199,31,168
"49","1500000US080310007021","080310007021","Block Group 1, Census Tract 7.02, Denver County, Colorado",970,707,7,700,263,0,263
"50","1500000US080310007022","080310007022","Block Group 2, Census Tract 7.02, Denver County, Colorado",1640,1198,188,1010,442,24,418
"51","1500000US080310007023","080310007023","Block Group 3, Census Tract 7.02, Denver County, Colorado",1302,864,104,760,438,0,438
"52","1500000US080310007024","080310007024","Block Group 4, Census Tract 7.02, Denver County, Colorado",633,605,14,591,28,10,18
"53","1500000US080310007025","080310007025","Block Group 5, Census Tract 7.02, Denver County, Colorado",628,558,50,508,70,0,70
"54","1500000US080310008001","080310008001","Block Group 1, Census Tract 8, Denver County, Colorado",1448,1103,162,941,345,0,345
"55","1500000US080310009021","080310009021","Block Group 1, Census Tract 9.02, Denver County, Colorado",592,413,10,403,179,0,179
"56","1500000US080310009022","080310009022","Block Group 2, Census Tract 9.02, Denver County, Colorado",972,520,43,477,452,0,452
"57","1500000US080310009023","080310009023","Block Group 3, Census Tract 9.02, Denver County, Colorado",1069,726,31,695,343,12,331
"58","1500000US080310009024","080310009024","Block Group 4, Census Tract 9.02, Denver County, Colorado",1822,1377,162,1215,445,30,415
"59","1500000US080310009025","080310009025","Block Group 5, Census Tract 9.02, Denver County, Colorado",1638,1135,25,1110,503,6,497
"60","1500000US080310009031","080310009031","Block Group 1, Census Tract 9.03, Denver County, Colorado",1404,958,229,729,446,15,431
"61","1500000US080310009032","080310009032","Block Group 2, Census Tract 9.03, Denver County, Colorado",1115,720,12,708,395,0,395
"62","1500000US080310009033","080310009033","Block Group 3, Census Tract 9.03, Denver County, Colorado",1295,963,129,834,332,35,297
"63","1500000US080310009034","080310009034","Block Group 4, Census Tract 9.03, Denver County, Colorado",1906,1486,16,1470,420,0,420
"64","1500000US080310009035","080310009035","Block Group 5, Census Tract 9.03, Denver County, Colorado",739,544,12,532,195,41,154
"65","1500000US080310009041","080310009041","Block Group 1, Census Tract 9.04, Denver County, Colorado",1090,644,0,644,446,0,446
"66","1500000US080310009042","080310009042","Block Group 2, Census Tract 9.04, Denver County, Colorado",1560,1204,80,1124,356,27,329
"67","1500000US080310009043","080310009043","Block Group 3, Census Tract 9.04, Denver County, Colorado",715,568,123,445,147,10,137
"68","1500000US080310009044","080310009044","Block Group 4, Census Tract 9.04, Denver County, Colorado",1746,1188,17,1171,558,0,558
"69","1500000US080310009051","080310009051","Block Group 1, Census Tract 9.05, Denver County, Colorado",862,670,129,541,192,0,192
"70","1500000US080310009052","080310009052","Block Group 2, Census Tract 9.05, Denver County, Colorado",1274,726,26,700,548,8,540
"71","1500000US080310009053","080310009053","Block Group 3, Census Tract 9.05, Denver County, Colorado",793,501,58,443,292,0,292
"72","1500000US080310009054","080310009054","Block Group 4, Census Tract 9.05, Denver County, Colorado",1274,1053,130,923,221,23,198
"73","1500000US080310010001","080310010001","Block Group 1, Census Tract 10, Denver County, Colorado",1386,771,134,637,615,45,570
"74","1500000US080310010002","080310010002","Block Group 2, Census Tract 10, Denver County, Colorado",788,517,23,494,271,17,254
"75","1500000US080310010003","080310010003","Block Group 3, Census Tract 10, Denver County, Colorado",1873,1181,63,1118,692,0,692
"76","1500000US080310011011","080310011011","Block Group 1, Census Tract 11.01, Denver County, Colorado",372,305,24,281,67,0,67
"77","1500000US080310011012","080310011012","Block Group 2, Census Tract 11.01, Denver County, Colorado",675,524,10,514,151,13,138
"78","1500000US080310011013","080310011013","Block Group 3, Census Tract 11.01, Denver County, Colorado",883,727,33,694,156,6,150
"79","1500000US080310011014","080310011014","Block Group 4, Census Tract 11.01, Denver County, Colorado",734,662,62,600,72,5,67
"80","1500000US080310011021","080310011021","Block Group 1, Census Tract 11.02, Denver County, Colorado",1021,809,7,802,212,8,204
"81","1500000US080310011022","080310011022","Block Group 2, Census Tract 11.02, Denver County, Colorado",710,566,8,558,144,0,144
"82","1500000US080310011023","080310011023","Block Group 3, Census Tract 11.02, Denver County, Colorado",1976,1802,69,1733,174,13,161
"83","1500000US080310013011","080310013011","Block Group 1, Census Tract 13.01, Denver County, Colorado",1252,767,81,686,485,6,479
"84","1500000US080310013012","080310013012","Block Group 2, Census Tract 13.01, Denver County, Colorado",1009,588,20,568,421,23,398
"85","1500000US080310013013","080310013013","Block Group 3, Census Tract 13.01, Denver County, Colorado",1327,1002,50,952,325,0,325
"86","1500000US080310013014","080310013014","Block Group 4, Census Tract 13.01, Denver County, Colorado",740,533,0,533,207,0,207
"87","1500000US080310013015","080310013015","Block Group 5, Census Tract 13.01, Denver County, Colorado",787,565,20,545,222,25,197
"88","1500000US080310013021","080310013021","Block Group 1, Census Tract 13.02, Denver County, Colorado",1754,1270,38,1232,484,0,484
"89","1500000US080310013022","080310013022","Block Group 2, Census Tract 13.02, Denver County, Colorado",947,657,47,610,290,6,284
"90","1500000US080310013023","080310013023","Block Group 3, Census Tract 13.02, Denver County, Colorado",1377,1213,32,1181,164,23,141
"91","1500000US080310014011","080310014011","Block Group 1, Census Tract 14.01, Denver County, Colorado",1067,728,42,686,339,29,310
"92","1500000US080310014012","080310014012","Block Group 2, Census Tract 14.01, Denver County, Colorado",538,427,98,329,111,13,98
"93","1500000US080310014013","080310014013","Block Group 3, Census Tract 14.01, Denver County, Colorado",1974,1283,9,1274,691,0,691
"94","1500000US080310014014","080310014014","Block Group 4, Census Tract 14.01, Denver County, Colorado",1639,1072,20,1052,567,84,483
"95","1500000US080310014015","080310014015","Block Group 5, Census Tract 14.01, Denver County, Colorado",1331,814,8,806,517,107,410
"96","1500000US080310014021","080310014021","Block Group 1, Census Tract 14.02, Denver County, Colorado",1287,751,0,751,536,38,498
"97","1500000US080310014022","080310014022","Block Group 2, Census Tract 14.02, Denver County, Colorado",816,483,40,443,333,35,298
"98","1500000US080310014023","080310014023","Block Group 3, Census Tract 14.02, Denver County, Colorado",1339,702,20,682,637,13,624
"99","1500000US080310014024","080310014024","Block Group 4, Census Tract 14.02, Denver County, Colorado",1265,859,35,824,406,0,406
"100","1500000US080310014031","080310014031","Block Group 1, Census Tract 14.03, Denver County, Colorado",1868,1644,60,1584,224,0,224
"101","1500000US080310014032","080310014032","Block Group 2, Census Tract 14.03, Denver County, Colorado",1293,1231,63,1168,62,0,62
"102","1500000US080310015001","080310015001","Block Group 1, Census Tract 15, Denver County, Colorado",1082,830,148,682,252,54,198
"103","1500000US080310015002","080310015002","Block Group 2, Census Tract 15, Denver County, Colorado",1535,1142,96,1046,393,43,350
"104","1500000US080310015003","080310015003","Block Group 3, Census Tract 15, Denver County, Colorado",1553,1304,33,1271,249,26,223
"105","1500000US080310016001","080310016001","Block Group 1, Census Tract 16, Denver County, Colorado",3529,2788,33,2755,741,0,741
"106","1500000US080310016002","080310016002","Block Group 2, Census Tract 16, Denver County, Colorado",5045,4801,669,4132,244,0,244
"107","1500000US080310016003","080310016003","Block Group 3, Census Tract 16, Denver County, Colorado",2256,2219,27,2192,37,0,37
"108","1500000US080310017011","080310017011","Block Group 1, Census Tract 17.01, Denver County, Colorado",1806,1701,35,1666,105,0,105
"109","1500000US080310017012","080310017012","Block Group 2, Census Tract 17.01, Denver County, Colorado",942,911,16,895,31,0,31
"110","1500000US080310017013","080310017013","Block Group 3, Census Tract 17.01, Denver County, Colorado",369,348,40,308,21,0,21
"111","1500000US080310017014","080310017014","Block Group 4, Census Tract 17.01, Denver County, Colorado",1320,1005,133,872,315,0,315
"112","1500000US080310017015","080310017015","Block Group 5, Census Tract 17.01, Denver County, Colorado",827,827,27,800,0,0,0
"113","1500000US080310017021","080310017021","Block Group 1, Census Tract 17.02, Denver County, Colorado",1695,1500,35,1465,195,37,158
"114","1500000US080310017022","080310017022","Block Group 2, Census Tract 17.02, Denver County, Colorado",2288,2162,50,2112,126,16,110
"115","1500000US080310018001","080310018001","Block Group 1, Census Tract 18, Denver County, Colorado",1858,1761,64,1697,97,42,55
"116","1500000US080310018002","080310018002","Block Group 2, Census Tract 18, Denver County, Colorado",1529,1148,12,1136,381,15,366
"117","1500000US080310019011","080310019011","Block Group 1, Census Tract 19.01, Denver County, Colorado",879,622,130,492,257,0,257
"118","1500000US080310019012","080310019012","Block Group 2, Census Tract 19.01, Denver County, Colorado",1763,1463,115,1348,300,9,291
"119","1500000US080310019021","080310019021","Block Group 1, Census Tract 19.02, Denver County, Colorado",812,727,28,699,85,0,85
"120","1500000US080310020001","080310020001","Block Group 1, Census Tract 20, Denver County, Colorado",1918,1725,101,1624,193,10,183
"121","1500000US080310021001","080310021001","Block Group 1, Census Tract 21, Denver County, Colorado",1140,1068,123,945,72,0,72
"122","1500000US080310021002","080310021002","Block Group 2, Census Tract 21, Denver County, Colorado",1516,1455,63,1392,61,0,61
"123","1500000US080310021003","080310021003","Block Group 3, Census Tract 21, Denver County, Colorado",1010,953,96,857,57,14,43
"124","1500000US080310021004","080310021004","Block Group 4, Census Tract 21, Denver County, Colorado",442,426,0,426,16,0,16
"125","1500000US080310021005","080310021005","Block Group 5, Census Tract 21, Denver County, Colorado",1763,1327,106,1221,436,0,436
"126","1500000US080310023001","080310023001","Block Group 1, Census Tract 23, Denver County, Colorado",2567,2233,182,2051,334,20,314
"127","1500000US080310023002","080310023002","Block Group 2, Census Tract 23, Denver County, Colorado",1056,1008,51,957,48,0,48
"128","1500000US080310023003","080310023003","Block Group 3, Census Tract 23, Denver County, Colorado",2365,2281,187,2094,84,0,84
"129","1500000US080310024021","080310024021","Block Group 1, Census Tract 24.02, Denver County, Colorado",1118,1036,90,946,82,13,69
"130","1500000US080310024022","080310024022","Block Group 2, Census Tract 24.02, Denver County, Colorado",769,742,112,630,27,12,15
"131","1500000US080310024031","080310024031","Block Group 1, Census Tract 24.03, Denver County, Colorado",1257,1170,56,1114,87,0,87
"132","1500000US080310024032","080310024032","Block Group 2, Census Tract 24.03, Denver County, Colorado",884,864,86,778,20,0,20
"133","1500000US080310024033","080310024033","Block Group 3, Census Tract 24.03, Denver County, Colorado",1492,1330,76,1254,162,12,150
"134","1500000US080310026011","080310026011","Block Group 1, Census Tract 26.01, Denver County, Colorado",1600,1452,58,1394,148,0,148
"135","1500000US080310026012","080310026012","Block Group 2, Census Tract 26.01, Denver County, Colorado",1532,1358,56,1302,174,0,174
"136","1500000US080310026021","080310026021","Block Group 1, Census Tract 26.02, Denver County, Colorado",2702,2560,95,2465,142,14,128
"137","1500000US080310027011","080310027011","Block Group 1, Census Tract 27.01, Denver County, Colorado",1030,1030,0,1030,0,0,0
"138","1500000US080310027012","080310027012","Block Group 2, Census Tract 27.01, Denver County, Colorado",1165,978,36,942,187,0,187
"139","1500000US080310027013","080310027013","Block Group 3, Census Tract 27.01, Denver County, Colorado",1637,1531,43,1488,106,21,85
"140","1500000US080310027014","080310027014","Block Group 4, Census Tract 27.01, Denver County, Colorado",841,828,49,779,13,13,0
"141","1500000US080310027021","080310027021","Block Group 1, Census Tract 27.02, Denver County, Colorado",1534,1500,0,1500,34,0,34
"142","1500000US080310027022","080310027022","Block Group 2, Census Tract 27.02, Denver County, Colorado",1617,1458,27,1431,159,0,159
"143","1500000US080310027023","080310027023","Block Group 3, Census Tract 27.02, Denver County, Colorado",1023,950,67,883,73,0,73
"144","1500000US080310027024","080310027024","Block Group 4, Census Tract 27.02, Denver County, Colorado",673,643,75,568,30,0,30
"145","1500000US080310027025","080310027025","Block Group 5, Census Tract 27.02, Denver County, Colorado",1110,1036,7,1029,74,19,55
"146","1500000US080310027031","080310027031","Block Group 1, Census Tract 27.03, Denver County, Colorado",1673,1511,89,1422,162,12,150
"147","1500000US080310027032","080310027032","Block Group 2, Census Tract 27.03, Denver County, Colorado",1257,1235,188,1047,22,22,0
"148","1500000US080310027033","080310027033","Block Group 3, Census Tract 27.03, Denver County, Colorado",1201,1086,32,1054,115,0,115
"149","1500000US080310027034","080310027034","Block Group 4, Census Tract 27.03, Denver County, Colorado",1110,1077,35,1042,33,0,33
"150","1500000US080310028011","080310028011","Block Group 1, Census Tract 28.01, Denver County, Colorado",1028,987,56,931,41,8,33
"151","1500000US080310028012","080310028012","Block Group 2, Census Tract 28.01, Denver County, Colorado",778,740,0,740,38,10,28
"152","1500000US080310028013","080310028013","Block Group 3, Census Tract 28.01, Denver County, Colorado",899,869,43,826,30,0,30
"153","1500000US080310028021","080310028021","Block Group 1, Census Tract 28.02, Denver County, Colorado",1728,1606,146,1460,122,12,110
"154","1500000US080310028022","080310028022","Block Group 2, Census Tract 28.02, Denver County, Colorado",764,706,11,695,58,0,58
"155","1500000US080310028023","080310028023","Block Group 3, Census Tract 28.02, Denver County, Colorado",1008,965,45,920,43,0,43
"156","1500000US080310028024","080310028024","Block Group 4, Census Tract 28.02, Denver County, Colorado",834,834,22,812,0,0,0
"157","1500000US080310028031","080310028031","Block Group 1, Census Tract 28.03, Denver County, Colorado",712,696,0,696,16,0,16
"158","1500000US080310028032","080310028032","Block Group 2, Census Tract 28.03, Denver County, Colorado",1236,1106,0,1106,130,0,130
"159","1500000US080310028033","080310028033","Block Group 3, Census Tract 28.03, Denver County, Colorado",1389,1376,83,1293,13,0,13
"160","1500000US080310028034","080310028034","Block Group 4, Census Tract 28.03, Denver County, Colorado",1321,1128,0,1128,193,0,193
"161","1500000US080310029011","080310029011","Block Group 1, Census Tract 29.01, Denver County, Colorado",891,851,48,803,40,0,40
"162","1500000US080310029012","080310029012","Block Group 2, Census Tract 29.01, Denver County, Colorado",1187,1095,64,1031,92,22,70
"163","1500000US080310029013","080310029013","Block Group 3, Census Tract 29.01, Denver County, Colorado",1168,1132,106,1026,36,9,27
"164","1500000US080310029021","080310029021","Block Group 1, Census Tract 29.02, Denver County, Colorado",1923,1870,162,1708,53,13,40
"165","1500000US080310029022","080310029022","Block Group 2, Census Tract 29.02, Denver County, Colorado",1290,1212,66,1146,78,0,78
"166","1500000US080310029023","080310029023","Block Group 3, Census Tract 29.02, Denver County, Colorado",1117,1101,41,1060,16,0,16
"167","1500000US080310030011","080310030011","Block Group 1, Census Tract 30.01, Denver County, Colorado",984,952,28,924,32,0,32
"168","1500000US080310030012","080310030012","Block Group 2, Census Tract 30.01, Denver County, Colorado",1272,1244,160,1084,28,0,28
"169","1500000US080310030013","080310030013","Block Group 3, Census Tract 30.01, Denver County, Colorado",958,912,0,912,46,0,46
"170","1500000US080310030014","080310030014","Block Group 4, Census Tract 30.01, Denver County, Colorado",1181,1078,129,949,103,16,87
"171","1500000US080310030015","080310030015","Block Group 5, Census Tract 30.01, Denver County, Colorado",1317,1316,0,1316,1,0,1
"172","1500000US080310030021","080310030021","Block Group 1, Census Tract 30.02, Denver County, Colorado",594,567,61,506,27,0,27
"173","1500000US080310030022","080310030022","Block Group 2, Census Tract 30.02, Denver County, Colorado",785,756,30,726,29,0,29
"174","1500000US080310030023","080310030023","Block Group 3, Census Tract 30.02, Denver County, Colorado",1181,1089,39,1050,92,0,92
"175","1500000US080310030031","080310030031","Block Group 1, Census Tract 30.03, Denver County, Colorado",1643,1598,156,1442,45,0,45
"176","1500000US080310030032","080310030032","Block Group 2, Census Tract 30.03, Denver County, Colorado",1648,1443,27,1416,205,0,205
"177","1500000US080310030041","080310030041","Block Group 1, Census Tract 30.04, Denver County, Colorado",2546,2091,8,2083,455,0,455
"178","1500000US080310030042","080310030042","Block Group 2, Census Tract 30.04, Denver County, Colorado",2141,2060,210,1850,81,0,81
"179","1500000US080310030043","080310030043","Block Group 3, Census Tract 30.04, Denver County, Colorado",1530,1379,56,1323,151,24,127
"180","1500000US080310031011","080310031011","Block Group 1, Census Tract 31.01, Denver County, Colorado",1576,1497,130,1367,79,5,74
"181","1500000US080310031021","080310031021","Block Group 1, Census Tract 31.02, Denver County, Colorado",1685,1554,55,1499,131,0,131
"182","1500000US080310031022","080310031022","Block Group 2, Census Tract 31.02, Denver County, Colorado",1633,1541,116,1425,92,0,92
"183","1500000US080310032011","080310032011","Block Group 1, Census Tract 32.01, Denver County, Colorado",1359,1228,62,1166,131,0,131
"184","1500000US080310032012","080310032012","Block Group 2, Census Tract 32.01, Denver County, Colorado",1471,1377,45,1332,94,0,94
"185","1500000US080310032013","080310032013","Block Group 3, Census Tract 32.01, Denver County, Colorado",1193,1030,0,1030,163,0,163
"186","1500000US080310032014","080310032014","Block Group 4, Census Tract 32.01, Denver County, Colorado",760,748,33,715,12,0,12
"187","1500000US080310032015","080310032015","Block Group 5, Census Tract 32.01, Denver County, Colorado",684,648,0,648,36,0,36
"188","1500000US080310032021","080310032021","Block Group 1, Census Tract 32.02, Denver County, Colorado",1101,1023,8,1015,78,0,78
"189","1500000US080310032022","080310032022","Block Group 2, Census Tract 32.02, Denver County, Colorado",811,778,53,725,33,13,20
"190","1500000US080310032023","080310032023","Block Group 3, Census Tract 32.02, Denver County, Colorado",1224,1062,28,1034,162,25,137
"191","1500000US080310032031","080310032031","Block Group 1, Census Tract 32.03, Denver County, Colorado",774,714,8,706,60,0,60
"192","1500000US080310032032","080310032032","Block Group 2, Census Tract 32.03, Denver County, Colorado",1222,1188,70,1118,34,0,34
"193","1500000US080310032033","080310032033","Block Group 3, Census Tract 32.03, Denver County, Colorado",1126,1049,70,979,77,0,77
"194","1500000US080310033001","080310033001","Block Group 1, Census Tract 33, Denver County, Colorado",1109,1075,51,1024,34,0,34
"195","1500000US080310033002","080310033002","Block Group 2, Census Tract 33, Denver County, Colorado",884,835,199,636,49,8,41
"196","1500000US080310033003","080310033003","Block Group 3, Census Tract 33, Denver County, Colorado",1002,897,27,870,105,0,105
"197","1500000US080310033004","080310033004","Block Group 4, Census Tract 33, Denver County, Colorado",565,557,0,557,8,0,8
"198","1500000US080310034011","080310034011","Block Group 1, Census Tract 34.01, Denver County, Colorado",550,544,16,528,6,0,6
"199","1500000US080310034012","080310034012","Block Group 2, Census Tract 34.01, Denver County, Colorado",1992,1852,128,1724,140,0,140
"200","1500000US080310034021","080310034021","Block Group 1, Census Tract 34.02, Denver County, Colorado",1202,1086,43,1043,116,0,116
"201","1500000US080310034022","080310034022","Block Group 2, Census Tract 34.02, Denver County, Colorado",2496,2353,191,2162,143,0,143
"202","1500000US080310034023","080310034023","Block Group 3, Census Tract 34.02, Denver County, Colorado",1123,1064,18,1046,59,19,40
"203","1500000US080310035001","080310035001","Block Group 1, Census Tract 35, Denver County, Colorado",856,695,13,682,161,16,145
"204","1500000US080310035002","080310035002","Block Group 2, Census Tract 35, Denver County, Colorado",1474,918,51,867,556,26,530
"205","1500000US080310035003","080310035003","Block Group 3, Census Tract 35, Denver County, Colorado",1648,999,64,935,649,38,611
"206","1500000US080310035004","080310035004","Block Group 4, Census Tract 35, Denver County, Colorado",1111,666,0,666,445,0,445
"207","1500000US080310035005","080310035005","Block Group 5, Census Tract 35, Denver County, Colorado",1831,1169,92,1077,662,152,510
"208","1500000US080310036011","080310036011","Block Group 1, Census Tract 36.01, Denver County, Colorado",1167,989,38,951,178,3,175
"209","1500000US080310036012","080310036012","Block Group 2, Census Tract 36.01, Denver County, Colorado",690,632,52,580,58,0,58
"210","1500000US080310036013","080310036013","Block Group 3, Census Tract 36.01, Denver County, Colorado",1676,1233,132,1101,443,15,428
"211","1500000US080310036014","080310036014","Block Group 4, Census Tract 36.01, Denver County, Colorado",467,313,23,290,154,0,154
"212","1500000US080310036015","080310036015","Block Group 5, Census Tract 36.01, Denver County, Colorado",549,402,22,380,147,81,66
"213","1500000US080310036021","080310036021","Block Group 1, Census Tract 36.02, Denver County, Colorado",1365,831,56,775,534,26,508
"214","1500000US080310036022","080310036022","Block Group 2, Census Tract 36.02, Denver County, Colorado",542,443,11,432,99,30,69
"215","1500000US080310036023","080310036023","Block Group 3, Census Tract 36.02, Denver County, Colorado",527,424,24,400,103,14,89
"216","1500000US080310036024","080310036024","Block Group 4, Census Tract 36.02, Denver County, Colorado",1061,960,0,960,101,0,101
"217","1500000US080310036025","080310036025","Block Group 5, Census Tract 36.02, Denver County, Colorado",1099,966,77,889,133,0,133
"218","1500000US080310036031","080310036031","Block Group 1, Census Tract 36.03, Denver County, Colorado",1341,1218,75,1143,123,26,97
"219","1500000US080310036032","080310036032","Block Group 2, Census Tract 36.03, Denver County, Colorado",1795,1743,66,1677,52,0,52
"220","1500000US080310037011","080310037011","Block Group 1, Census Tract 37.01, Denver County, Colorado",1637,1501,123,1378,136,0,136
"221","1500000US080310037012","080310037012","Block Group 2, Census Tract 37.01, Denver County, Colorado",1757,1682,73,1609,75,0,75
"222","1500000US080310037021","080310037021","Block Group 1, Census Tract 37.02, Denver County, Colorado",1801,1783,131,1652,18,18,0
"223","1500000US080310037022","080310037022","Block Group 2, Census Tract 37.02, Denver County, Colorado",817,728,21,707,89,0,89
"224","1500000US080310037023","080310037023","Block Group 3, Census Tract 37.02, Denver County, Colorado",959,939,21,918,20,0,20
"225","1500000US080310037024","080310037024","Block Group 4, Census Tract 37.02, Denver County, Colorado",1263,1228,91,1137,35,0,35
"226","1500000US080310037031","080310037031","Block Group 1, Census Tract 37.03, Denver County, Colorado",1400,1264,68,1196,136,18,118
"227","1500000US080310037032","080310037032","Block Group 2, Census Tract 37.03, Denver County, Colorado",1693,1624,150,1474,69,0,69
"228","1500000US080310038001","080310038001","Block Group 1, Census Tract 38, Denver County, Colorado",1039,954,23,931,85,0,85
"229","1500000US080310038002","080310038002","Block Group 2, Census Tract 38, Denver County, Colorado",488,474,0,474,14,0,14
"230","1500000US080310038003","080310038003","Block Group 3, Census Tract 38, Denver County, Colorado",1899,1593,19,1574,306,19,287
"231","1500000US080310038004","080310038004","Block Group 4, Census Tract 38, Denver County, Colorado",1775,1580,61,1519,195,0,195
"232","1500000US080310038005","080310038005","Block Group 5, Census Tract 38, Denver County, Colorado",1487,1251,0,1251,236,0,236
"233","1500000US080310039011","080310039011","Block Group 1, Census Tract 39.01, Denver County, Colorado",2046,1781,161,1620,265,0,265
"234","1500000US080310039012","080310039012","Block Group 2, Census Tract 39.01, Denver County, Colorado",985,908,97,811,77,0,77
"235","1500000US080310039013","080310039013","Block Group 3, Census Tract 39.01, Denver County, Colorado",1566,1484,171,1313,82,19,63
"236","1500000US080310039021","080310039021","Block Group 1, Census Tract 39.02, Denver County, Colorado",1333,1309,33,1276,24,0,24
"237","1500000US080310039022","080310039022","Block Group 2, Census Tract 39.02, Denver County, Colorado",1983,1938,89,1849,45,21,24
"238","1500000US080310039023","080310039023","Block Group 3, Census Tract 39.02, Denver County, Colorado",1367,1329,66,1263,38,0,38
"239","1500000US080310040021","080310040021","Block Group 1, Census Tract 40.02, Denver County, Colorado",831,784,36,748,47,0,47
"240","1500000US080310040022","080310040022","Block Group 2, Census Tract 40.02, Denver County, Colorado",831,786,28,758,45,0,45
"241","1500000US080310040023","080310040023","Block Group 3, Census Tract 40.02, Denver County, Colorado",768,723,49,674,45,2,43
"242","1500000US080310040024","080310040024","Block Group 4, Census Tract 40.02, Denver County, Colorado",987,951,17,934,36,0,36
"243","1500000US080310040031","080310040031","Block Group 1, Census Tract 40.03, Denver County, Colorado",1166,1137,153,984,29,13,16
"244","1500000US080310040032","080310040032","Block Group 2, Census Tract 40.03, Denver County, Colorado",1381,1373,67,1306,8,0,8
"245","1500000US080310040033","080310040033","Block Group 3, Census Tract 40.03, Denver County, Colorado",881,740,188,552,141,0,141
"246","1500000US080310040034","080310040034","Block Group 4, Census Tract 40.03, Denver County, Colorado",915,909,0,909,6,0,6
"247","1500000US080310040041","080310040041","Block Group 1, Census Tract 40.04, Denver County, Colorado",1868,1757,39,1718,111,3,108
"248","1500000US080310040051","080310040051","Block Group 1, Census Tract 40.05, Denver County, Colorado",1492,1314,13,1301,178,0,178
"249","1500000US080310040052","080310040052","Block Group 2, Census Tract 40.05, Denver County, Colorado",1577,1315,132,1183,262,35,227
"250","1500000US080310040061","080310040061","Block Group 1, Census Tract 40.06, Denver County, Colorado",1131,1072,75,997,59,18,41
"251","1500000US080310040062","080310040062","Block Group 2, Census Tract 40.06, Denver County, Colorado",1420,1130,40,1090,290,39,251
"252","1500000US080310040063","080310040063","Block Group 3, Census Tract 40.06, Denver County, Colorado",1202,937,115,822,265,71,194
"253","1500000US080310040064","080310040064","Block Group 4, Census Tract 40.06, Denver County, Colorado",913,888,0,888,25,0,25
"254","1500000US080310041011","080310041011","Block Group 1, Census Tract 41.01, Denver County, Colorado",1979,1699,14,1685,280,0,280
"255","1500000US080310041012","080310041012","Block Group 2, Census Tract 41.01, Denver County, Colorado",1500,1426,9,1417,74,0,74
"256","1500000US080310041013","080310041013","Block Group 3, Census Tract 41.01, Denver County, Colorado",959,790,171,619,169,0,169
"257","1500000US080310041021","080310041021","Block Group 1, Census Tract 41.02, Denver County, Colorado",1487,1248,50,1198,239,0,239
"258","1500000US080310041022","080310041022","Block Group 2, Census Tract 41.02, Denver County, Colorado",1029,838,97,741,191,12,179
"259","1500000US080310041023","080310041023","Block Group 3, Census Tract 41.02, Denver County, Colorado",969,852,57,795,117,0,117
"260","1500000US080310041024","080310041024","Block Group 4, Census Tract 41.02, Denver County, Colorado",1284,1236,120,1116,48,20,28
"261","1500000US080310041031","080310041031","Block Group 1, Census Tract 41.03, Denver County, Colorado",1158,767,49,718,391,62,329
"262","1500000US080310041032","080310041032","Block Group 2, Census Tract 41.03, Denver County, Colorado",802,802,74,728,0,0,0
"263","1500000US080310041033","080310041033","Block Group 3, Census Tract 41.03, Denver County, Colorado",957,902,132,770,55,42,13
"264","1500000US080310041034","080310041034","Block Group 4, Census Tract 41.03, Denver County, Colorado",874,841,29,812,33,0,33
"265","1500000US080310041035","080310041035","Block Group 5, Census Tract 41.03, Denver County, Colorado",984,974,121,853,10,0,10
"266","1500000US080310041036","080310041036","Block Group 6, Census Tract 41.03, Denver County, Colorado",825,825,40,785,0,0,0
"267","1500000US080310041041","080310041041","Block Group 1, Census Tract 41.04, Denver County, Colorado",996,831,50,781,165,7,158
"268","1500000US080310041042","080310041042","Block Group 2, Census Tract 41.04, Denver County, Colorado",1001,995,93,902,6,0,6
"269","1500000US080310041043","080310041043","Block Group 3, Census Tract 41.04, Denver County, Colorado",891,820,8,812,71,0,71
"270","1500000US080310041044","080310041044","Block Group 4, Census Tract 41.04, Denver County, Colorado",475,475,54,421,0,0,0
"271","1500000US080310041045","080310041045","Block Group 5, Census Tract 41.04, Denver County, Colorado",767,716,69,647,51,0,51
"272","1500000US080310041046","080310041046","Block Group 6, Census Tract 41.04, Denver County, Colorado",609,591,11,580,18,0,18
"273","1500000US080310041061","080310041061","Block Group 1, Census Tract 41.06, Denver County, Colorado",12563,11908,609,11299,655,13,642
"274","1500000US080310041071","080310041071","Block Group 1, Census Tract 41.07, Denver County, Colorado",6937,6628,266,6362,309,0,309
"275","1500000US080310042011","080310042011","Block Group 1, Census Tract 42.01, Denver County, Colorado",1204,1158,124,1034,46,10,36
"276","1500000US080310042012","080310042012","Block Group 2, Census Tract 42.01, Denver County, Colorado",713,629,8,621,84,0,84
"277","1500000US080310042013","080310042013","Block Group 3, Census Tract 42.01, Denver County, Colorado",722,696,60,636,26,0,26
"278","1500000US080310042014","080310042014","Block Group 4, Census Tract 42.01, Denver County, Colorado",837,535,24,511,302,73,229
"279","1500000US080310042015","080310042015","Block Group 5, Census Tract 42.01, Denver County, Colorado",735,726,73,653,9,0,9
"280","1500000US080310042016","080310042016","Block Group 6, Census Tract 42.01, Denver County, Colorado",558,539,16,523,19,7,12
"281","1500000US080310042021","080310042021","Block Group 1, Census Tract 42.02, Denver County, Colorado",743,416,0,416,327,0,327
"282","1500000US080310042022","080310042022","Block Group 2, Census Tract 42.02, Denver County, Colorado",778,771,32,739,7,0,7
"283","1500000US080310042023","080310042023","Block Group 3, Census Tract 42.02, Denver County, Colorado",1671,1594,70,1524,77,15,62
"284","1500000US080310042024","080310042024","Block Group 4, Census Tract 42.02, Denver County, Colorado",617,578,25,553,39,0,39
"285","1500000US080310042025","080310042025","Block Group 5, Census Tract 42.02, Denver County, Colorado",706,696,46,650,10,0,10
"286","1500000US080310043011","080310043011","Block Group 1, Census Tract 43.01, Denver County, Colorado",1303,1230,62,1168,73,15,58
"287","1500000US080310043012","080310043012","Block Group 2, Census Tract 43.01, Denver County, Colorado",888,793,0,793,95,0,95
"288","1500000US080310043013","080310043013","Block Group 3, Census Tract 43.01, Denver County, Colorado",947,855,16,839,92,11,81
"289","1500000US080310043014","080310043014","Block Group 4, Census Tract 43.01, Denver County, Colorado",1402,1159,176,983,243,0,243
"290","1500000US080310043021","080310043021","Block Group 1, Census Tract 43.02, Denver County, Colorado",762,754,0,754,8,0,8
"291","1500000US080310043022","080310043022","Block Group 2, Census Tract 43.02, Denver County, Colorado",907,875,8,867,32,0,32
"292","1500000US080310043023","080310043023","Block Group 3, Census Tract 43.02, Denver County, Colorado",750,711,8,703,39,0,39
"293","1500000US080310043031","080310043031","Block Group 1, Census Tract 43.03, Denver County, Colorado",1578,1525,123,1402,53,0,53
"294","1500000US080310043032","080310043032","Block Group 2, Census Tract 43.03, Denver County, Colorado",1041,951,17,934,90,9,81
"295","1500000US080310043033","080310043033","Block Group 3, Census Tract 43.03, Denver County, Colorado",526,400,0,400,126,0,126
"296","1500000US080310043034","080310043034","Block Group 4, Census Tract 43.03, Denver County, Colorado",909,842,10,832,67,0,67
"297","1500000US080310043041","080310043041","Block Group 1, Census Tract 43.04, Denver County, Colorado",1186,1165,163,1002,21,14,7
"298","1500000US080310043042","080310043042","Block Group 2, Census Tract 43.04, Denver County, Colorado",1148,1046,25,1021,102,0,102
"299","1500000US080310043043","080310043043","Block Group 3, Census Tract 43.04, Denver County, Colorado",1812,1651,16,1635,161,0,161
"300","1500000US080310043044","080310043044","Block Group 4, Census Tract 43.04, Denver County, Colorado",1739,1400,65,1335,339,81,258
"301","1500000US080310043061","080310043061","Block Group 1, Census Tract 43.06, Denver County, Colorado",458,447,0,447,11,0,11
"302","1500000US080310043062","080310043062","Block Group 2, Census Tract 43.06, Denver County, Colorado",821,798,0,798,23,0,23
"303","1500000US080310043063","080310043063","Block Group 3, Census Tract 43.06, Denver County, Colorado",1816,1554,158,1396,262,37,225
"304","1500000US080310043064","080310043064","Block Group 4, Census Tract 43.06, Denver County, Colorado",851,829,0,829,22,0,22
"305","1500000US080310043065","080310043065","Block Group 5, Census Tract 43.06, Denver County, Colorado",1311,1297,57,1240,14,0,14
"306","1500000US080310044031","080310044031","Block Group 1, Census Tract 44.03, Denver County, Colorado",753,617,14,603,136,0,136
"307","1500000US080310044032","080310044032","Block Group 2, Census Tract 44.03, Denver County, Colorado",2283,1890,111,1779,393,25,368
"308","1500000US080310044033","080310044033","Block Group 3, Census Tract 44.03, Denver County, Colorado",1500,1360,149,1211,140,40,100
"309","1500000US080310044041","080310044041","Block Group 1, Census Tract 44.04, Denver County, Colorado",1693,1630,95,1535,63,17,46
"310","1500000US080310044042","080310044042","Block Group 2, Census Tract 44.04, Denver County, Colorado",2743,1863,121,1742,880,0,880
"311","1500000US080310044043","080310044043","Block Group 3, Census Tract 44.04, Denver County, Colorado",1982,1219,89,1130,763,0,763
"312","1500000US080310044051","080310044051","Block Group 1, Census Tract 44.05, Denver County, Colorado",1560,1350,127,1223,210,52,158
"313","1500000US080310044052","080310044052","Block Group 2, Census Tract 44.05, Denver County, Colorado",1293,1211,62,1149,82,0,82
"314","1500000US080310044053","080310044053","Block Group 3, Census Tract 44.05, Denver County, Colorado",1212,1086,16,1070,126,3,123
"315","1500000US080310044054","080310044054","Block Group 4, Census Tract 44.05, Denver County, Colorado",4187,3668,303,3365,519,0,519
"316","1500000US080310045031","080310045031","Block Group 1, Census Tract 45.03, Denver County, Colorado",1399,1056,0,1056,343,0,343
"317","1500000US080310045032","080310045032","Block Group 2, Census Tract 45.03, Denver County, Colorado",1391,856,78,778,535,17,518
"318","1500000US080310045033","080310045033","Block Group 3, Census Tract 45.03, Denver County, Colorado",1295,836,0,836,459,0,459
"319","1500000US080310045041","080310045041","Block Group 1, Census Tract 45.04, Denver County, Colorado",1488,973,15,958,515,0,515
"320","1500000US080310045042","080310045042","Block Group 2, Census Tract 45.04, Denver County, Colorado",2025,1563,68,1495,462,33,429
"321","1500000US080310045043","080310045043","Block Group 3, Census Tract 45.04, Denver County, Colorado",993,770,114,656,223,0,223
"322","1500000US080310045051","080310045051","Block Group 1, Census Tract 45.05, Denver County, Colorado",2668,1743,186,1557,925,30,895
"323","1500000US080310045052","080310045052","Block Group 2, Census Tract 45.05, Denver County, Colorado",750,530,10,520,220,5,215
"324","1500000US080310045053","080310045053","Block Group 3, Census Tract 45.05, Denver County, Colorado",1188,753,26,727,435,0,435
"325","1500000US080310045061","080310045061","Block Group 1, Census Tract 45.06, Denver County, Colorado",849,633,0,633,216,0,216
"326","1500000US080310045062","080310045062","Block Group 2, Census Tract 45.06, Denver County, Colorado",1424,928,27,901,496,14,482
"327","1500000US080310045063","080310045063","Block Group 3, Census Tract 45.06, Denver County, Colorado",1448,958,24,934,490,52,438
"328","1500000US080310046011","080310046011","Block Group 1, Census Tract 46.01, Denver County, Colorado",1186,967,0,967,219,0,219
"329","1500000US080310046012","080310046012","Block Group 2, Census Tract 46.01, Denver County, Colorado",1479,1131,0,1131,348,7,341
"330","1500000US080310046013","080310046013","Block Group 3, Census Tract 46.01, Denver County, Colorado",1929,1523,96,1427,406,10,396
"331","1500000US080310046014","080310046014","Block Group 4, Census Tract 46.01, Denver County, Colorado",1010,930,0,930,80,0,80
"332","1500000US080310046021","080310046021","Block Group 1, Census Tract 46.02, Denver County, Colorado",2551,1613,237,1376,938,17,921
"333","1500000US080310046022","080310046022","Block Group 2, Census Tract 46.02, Denver County, Colorado",3144,2117,79,2038,1027,0,1027
"334","1500000US080310046023","080310046023","Block Group 3, Census Tract 46.02, Denver County, Colorado",1306,826,0,826,480,0,480
"335","1500000US080310046024","080310046024","Block Group 4, Census Tract 46.02, Denver County, Colorado",1416,862,34,828,554,14,540
"336","1500000US080310046031","080310046031","Block Group 1, Census Tract 46.03, Denver County, Colorado",1186,804,44,760,382,20,362
"337","1500000US080310046032","080310046032","Block Group 2, Census Tract 46.03, Denver County, Colorado",838,631,0,631,207,151,56
"338","1500000US080310046033","080310046033","Block Group 3, Census Tract 46.03, Denver County, Colorado",1088,929,44,885,159,38,121
"339","1500000US080310046034","080310046034","Block Group 4, Census Tract 46.03, Denver County, Colorado",1666,1451,61,1390,215,83,132
"340","1500000US080310046035","080310046035","Block Group 5, Census Tract 46.03, Denver County, Colorado",1200,984,84,900,216,0,216
"341","1500000US080310047001","080310047001","Block Group 1, Census Tract 47, Denver County, Colorado",552,398,0,398,154,0,154
"342","1500000US080310047002","080310047002","Block Group 2, Census Tract 47, Denver County, Colorado",724,574,0,574,150,0,150
"343","1500000US080310047003","080310047003","Block Group 3, Census Tract 47, Denver County, Colorado",853,682,0,682,171,0,171
"344","1500000US080310047004","080310047004","Block Group 4, Census Tract 47, Denver County, Colorado",485,411,0,411,74,0,74
"345","1500000US080310047005","080310047005","Block Group 5, Census Tract 47, Denver County, Colorado",1554,1537,0,1537,17,0,17
"346","1500000US080310047006","080310047006","Block Group 6, Census Tract 47, Denver County, Colorado",2614,1571,0,1571,1043,0,1043
"347","1500000US080310048011","080310048011","Block Group 1, Census Tract 48.01, Denver County, Colorado",922,878,41,837,44,28,16
"348","1500000US080310048012","080310048012","Block Group 2, Census Tract 48.01, Denver County, Colorado",1695,1445,0,1445,250,61,189
"349","1500000US080310048013","080310048013","Block Group 3, Census Tract 48.01, Denver County, Colorado",604,506,74,432,98,0,98
"350","1500000US080310050011","080310050011","Block Group 1, Census Tract 50.01, Denver County, Colorado",1950,1593,127,1466,357,48,309
"351","1500000US080310050012","080310050012","Block Group 2, Census Tract 50.01, Denver County, Colorado",1089,975,79,896,114,0,114
"352","1500000US080310050021","080310050021","Block Group 1, Census Tract 50.02, Denver County, Colorado",770,675,78,597,95,0,95
"353","1500000US080310050022","080310050022","Block Group 2, Census Tract 50.02, Denver County, Colorado",918,714,72,642,204,0,204
"354","1500000US080310050023","080310050023","Block Group 3, Census Tract 50.02, Denver County, Colorado",1817,1711,223,1488,106,12,94
"355","1500000US080310050024","080310050024","Block Group 4, Census Tract 50.02, Denver County, Colorado",2880,1855,324,1531,1025,0,1025
"356","1500000US080310050025","080310050025","Block Group 5, Census Tract 50.02, Denver County, Colorado",794,782,70,712,12,0,12
"357","1500000US080310051021","080310051021","Block Group 1, Census Tract 51.02, Denver County, Colorado",683,611,56,555,72,0,72
"358","1500000US080310051022","080310051022","Block Group 2, Census Tract 51.02, Denver County, Colorado",583,539,23,516,44,0,44
"359","1500000US080310051023","080310051023","Block Group 3, Census Tract 51.02, Denver County, Colorado",1300,1185,68,1117,115,71,44
"360","1500000US080310051024","080310051024","Block Group 4, Census Tract 51.02, Denver County, Colorado",1170,1048,101,947,122,0,122
"361","1500000US080310051041","080310051041","Block Group 1, Census Tract 51.04, Denver County, Colorado",2003,1469,176,1293,534,41,493
"362","1500000US080310051042","080310051042","Block Group 2, Census Tract 51.04, Denver County, Colorado",1542,1223,31,1192,319,21,298
"363","1500000US080310052001","080310052001","Block Group 1, Census Tract 52, Denver County, Colorado",547,512,0,512,35,0,35
"364","1500000US080310052002","080310052002","Block Group 2, Census Tract 52, Denver County, Colorado",636,575,48,527,61,14,47
"365","1500000US080310052003","080310052003","Block Group 3, Census Tract 52, Denver County, Colorado",1404,1262,31,1231,142,0,142
"366","1500000US080310052004","080310052004","Block Group 4, Census Tract 52, Denver County, Colorado",881,789,32,757,92,0,92
"367","1500000US080310053001","080310053001","Block Group 1, Census Tract 53, Denver County, Colorado",1363,1254,9,1245,109,6,103
"368","1500000US080310055021","080310055021","Block Group 1, Census Tract 55.02, Denver County, Colorado",2048,1885,66,1819,163,14,149
"369","1500000US080310055031","080310055031","Block Group 1, Census Tract 55.03, Denver County, Colorado",741,642,30,612,99,30,69
"370","1500000US080310055032","080310055032","Block Group 2, Census Tract 55.03, Denver County, Colorado",2395,2278,119,2159,117,5,112
"371","1500000US080310055033","080310055033","Block Group 3, Census Tract 55.03, Denver County, Colorado",1012,962,18,944,50,0,50
"372","1500000US080310055034","080310055034","Block Group 4, Census Tract 55.03, Denver County, Colorado",727,727,11,716,0,0,0
"373","1500000US080310067011","080310067011","Block Group 1, Census Tract 67.01, Denver County, Colorado",3231,2736,78,2658,495,51,444
"374","1500000US080310068041","080310068041","Block Group 1, Census Tract 68.04, Denver County, Colorado",796,657,65,592,139,96,43
"375","1500000US080310068042","080310068042","Block Group 2, Census Tract 68.04, Denver County, Colorado",1627,1462,90,1372,165,0,165
"376","1500000US080310068091","080310068091","Block Group 1, Census Tract 68.09, Denver County, Colorado",839,759,0,759,80,0,80
"377","1500000US080310068092","080310068092","Block Group 2, Census Tract 68.09, Denver County, Colorado",2573,2443,111,2332,130,0,130
"378","1500000US080310068093","080310068093","Block Group 3, Census Tract 68.09, Denver County, Colorado",1267,1253,84,1169,14,14,0
"379","1500000US080310068094","080310068094","Block Group 4, Census Tract 68.09, Denver County, Colorado",1066,757,7,750,309,0,309
"380","1500000US080310068095","080310068095","Block Group 5, Census Tract 68.09, Denver County, Colorado",911,681,39,642,230,0,230
"381","1500000US080310068096","080310068096","Block Group 6, Census Tract 68.09, Denver County, Colorado",669,640,16,624,29,0,29
"382","1500000US080310068101","080310068101","Block Group 1, Census Tract 68.10, Denver County, Colorado",1118,1051,0,1051,67,0,67
"383","1500000US080310068102","080310068102","Block Group 2, Census Tract 68.10, Denver County, Colorado",1900,1676,59,1617,224,0,224
"384","1500000US080310068103","080310068103","Block Group 3, Census Tract 68.10, Denver County, Colorado",721,706,0,706,15,0,15
"385","1500000US080310068104","080310068104","Block Group 4, Census Tract 68.10, Denver County, Colorado",1844,1705,370,1335,139,0,139
"386","1500000US080310068111","080310068111","Block Group 1, Census Tract 68.11, Denver County, Colorado",2250,1991,106,1885,259,27,232
"387","1500000US080310068112","080310068112","Block Group 2, Census Tract 68.11, Denver County, Colorado",579,483,24,459,96,0,96
"388","1500000US080310068113","080310068113","Block Group 3, Census Tract 68.11, Denver County, Colorado",1863,1496,94,1402,367,0,367
"389","1500000US080310068114","080310068114","Block Group 4, Census Tract 68.11, Denver County, Colorado",1498,1374,53,1321,124,0,124
"390","1500000US080310068121","080310068121","Block Group 1, Census Tract 68.12, Denver County, Colorado",1742,1656,136,1520,86,16,70
"391","1500000US080310068122","080310068122","Block Group 2, Census Tract 68.12, Denver County, Colorado",1309,1209,26,1183,100,0,100
"392","1500000US080310068123","080310068123","Block Group 3, Census Tract 68.12, Denver County, Colorado",813,720,0,720,93,0,93
"393","1500000US080310068131","080310068131","Block Group 1, Census Tract 68.13, Denver County, Colorado",1032,924,132,792,108,0,108
"394","1500000US080310068132","080310068132","Block Group 2, Census Tract 68.13, Denver County, Colorado",1664,1025,34,991,639,0,639
"395","1500000US080310068133","080310068133","Block Group 3, Census Tract 68.13, Denver County, Colorado",1562,1277,156,1121,285,70,215
"396","1500000US080310068141","080310068141","Block Group 1, Census Tract 68.14, Denver County, Colorado",454,446,7,439,8,8,0
"397","1500000US080310068142","080310068142","Block Group 2, Census Tract 68.14, Denver County, Colorado",1239,968,49,919,271,47,224
"398","1500000US080310068143","080310068143","Block Group 3, Census Tract 68.14, Denver County, Colorado",2081,1883,414,1469,198,17,181
"399","1500000US080310068144","080310068144","Block Group 4, Census Tract 68.14, Denver County, Colorado",702,628,39,589,74,0,74
"400","1500000US080310069011","080310069011","Block Group 1, Census Tract 69.01, Denver County, Colorado",2266,1825,161,1664,441,59,382
"401","1500000US080310069012","080310069012","Block Group 2, Census Tract 69.01, Denver County, Colorado",1391,1265,33,1232,126,8,118
"402","1500000US080310069013","080310069013","Block Group 3, Census Tract 69.01, Denver County, Colorado",601,575,0,575,26,0,26
"403","1500000US080310069014","080310069014","Block Group 4, Census Tract 69.01, Denver County, Colorado",847,633,133,500,214,63,151
"404","1500000US080310069015","080310069015","Block Group 5, Census Tract 69.01, Denver County, Colorado",373,356,35,321,17,0,17
"405","1500000US080310070061","080310070061","Block Group 1, Census Tract 70.06, Denver County, Colorado",2412,1614,75,1539,798,37,761
"406","1500000US080310070062","080310070062","Block Group 2, Census Tract 70.06, Denver County, Colorado",2359,1388,154,1234,971,64,907
"407","1500000US080310070131","080310070131","Block Group 1, Census Tract 70.13, Denver County, Colorado",2455,2034,157,1877,421,91,330
"408","1500000US080310070132","080310070132","Block Group 2, Census Tract 70.13, Denver County, Colorado",1191,1138,0,1138,53,0,53
"409","1500000US080310070371","080310070371","Block Group 1, Census Tract 70.37, Denver County, Colorado",2663,1432,83,1349,1231,82,1149
"410","1500000US080310070372","080310070372","Block Group 2, Census Tract 70.37, Denver County, Colorado",945,791,196,595,154,55,99
"411","1500000US080310070373","080310070373","Block Group 3, Census Tract 70.37, Denver County, Colorado",677,354,0,354,323,26,297
"412","1500000US080310070881","080310070881","Block Group 1, Census Tract 70.88, Denver County, Colorado",1325,1042,31,1011,283,16,267
"413","1500000US080310070882","080310070882","Block Group 2, Census Tract 70.88, Denver County, Colorado",912,481,146,335,431,97,334
"414","1500000US080310070883","080310070883","Block Group 3, Census Tract 70.88, Denver County, Colorado",1326,1047,40,1007,279,0,279
"415","1500000US080310070884","080310070884","Block Group 4, Census Tract 70.88, Denver County, Colorado",1058,793,60,733,265,15,250
"416","1500000US080310070891","080310070891","Block Group 1, Census Tract 70.89, Denver County, Colorado",408,408,30,378,0,0,0
"417","1500000US080310070892","080310070892","Block Group 2, Census Tract 70.89, Denver County, Colorado",1185,1122,18,1104,63,0,63
"418","1500000US080310070893","080310070893","Block Group 3, Census Tract 70.89, Denver County, Colorado",1659,1560,97,1463,99,13,86
"419","1500000US080310070894","080310070894","Block Group 4, Census Tract 70.89, Denver County, Colorado",1523,1121,0,1121,402,0,402
"420","1500000US080310083041","080310083041","Block Group 1, Census Tract 83.04, Denver County, Colorado",2092,1634,203,1431,458,45,413
"421","1500000US080310083042","080310083042","Block Group 2, Census Tract 83.04, Denver County, Colorado",1228,829,18,811,399,9,390
"422","1500000US080310083043","080310083043","Block Group 3, Census Tract 83.04, Denver County, Colorado",794,534,34,500,260,0,260
"423","1500000US080310083051","080310083051","Block Group 1, Census Tract 83.05, Denver County, Colorado",1486,980,213,767,506,56,450
"424","1500000US080310083052","080310083052","Block Group 2, Census Tract 83.05, Denver County, Colorado",1420,833,25,808,587,37,550
"425","1500000US080310083053","080310083053","Block Group 3, Census Tract 83.05, Denver County, Colorado",1613,1302,104,1198,311,31,280
"426","1500000US080310083061","080310083061","Block Group 1, Census Tract 83.06, Denver County, Colorado",811,687,73,614,124,7,117
"427","1500000US080310083062","080310083062","Block Group 2, Census Tract 83.06, Denver County, Colorado",1607,1324,179,1145,283,57,226
"428","1500000US080310083063","080310083063","Block Group 3, Census Tract 83.06, Denver County, Colorado",868,621,17,604,247,54,193
"429","1500000US080310083064","080310083064","Block Group 4, Census Tract 83.06, Denver County, Colorado",3079,1996,84,1912,1083,60,1023
"430","1500000US080310083121","080310083121","Block Group 1, Census Tract 83.12, Denver County, Colorado",3281,2386,366,2020,895,220,675
"431","1500000US080310083122","080310083122","Block Group 2, Census Tract 83.12, Denver County, Colorado",2392,1715,85,1630,677,78,599
"432","1500000US080310083123","080310083123","Block Group 3, Census Tract 83.12, Denver County, Colorado",2361,1737,230,1507,624,126,498
"433","1500000US080310083861","080310083861","Block Group 1, Census Tract 83.86, Denver County, Colorado",2274,1750,107,1643,524,8,516
"434","1500000US080310083862","080310083862","Block Group 2, Census Tract 83.86, Denver County, Colorado",2631,1763,27,1736,868,18,850
"435","1500000US080310083871","080310083871","Block Group 1, Census Tract 83.87, Denver County, Colorado",3720,2636,24,2612,1084,0,1084
"436","1500000US080310083872","080310083872","Block Group 2, Census Tract 83.87, Denver County, Colorado",3308,2112,135,1977,1196,72,1124
"437","1500000US080310083881","080310083881","Block Group 1, Census Tract 83.88, Denver County, Colorado",7166,5068,383,4685,2098,261,1837
"438","1500000US080310083882","080310083882","Block Group 2, Census Tract 83.88, Denver County, Colorado",1366,1068,0,1068,298,0,298
"439","1500000US080310083891","080310083891","Block Group 1, Census Tract 83.89, Denver County, Colorado",1223,995,21,974,228,123,105
"440","1500000US080310083892","080310083892","Block Group 2, Census Tract 83.89, Denver County, Colorado",2324,1812,209,1603,512,16,496
"441","1500000US080310083893","080310083893","Block Group 3, Census Tract 83.89, Denver County, Colorado",6675,4655,644,4011,2020,320,1700
"442","1500000US080310083901","080310083901","Block Group 1, Census Tract 83.90, Denver County, Colorado",3246,2020,309,1711,1226,132,1094
"443","1500000US080310083902","080310083902","Block Group 2, Census Tract 83.90, Denver County, Colorado",3276,2631,362,2269,645,68,577
"444","1500000US080310083903","080310083903","Block Group 3, Census Tract 83.90, Denver County, Colorado",2814,2015,121,1894,799,64,735
"445","1500000US080310083911","080310083911","Block Group 1, Census Tract 83.91, Denver County, Colorado",4412,3606,177,3429,806,0,806
"446","1500000US080310083912","080310083912","Block Group 2, Census Tract 83.91, Denver County, Colorado",3538,2613,68,2545,925,52,873
"447","1500000US080310119021","080310119021","Block Group 1, Census Tract 119.02, Denver County, Colorado",2069,2069,0,2069,0,0,0
"448","1500000US080310119022","080310119022","Block Group 2, Census Tract 119.02, Denver County, Colorado",1416,1292,51,1241,124,0,124
"449","1500000US080310119023","080310119023","Block Group 3, Census Tract 119.02, Denver County, Colorado",1745,1602,17,1585,143,0,143
"450","1500000US080310119024","080310119024","Block Group 4, Census Tract 119.02, Denver County, Colorado",1372,1153,40,1113,219,0,219
"451","1500000US080310119031","080310119031","Block Group 1, Census Tract 119.03, Denver County, Colorado",1519,1373,35,1338,146,8,138
"452","1500000US080310119032","080310119032","Block Group 2, Census Tract 119.03, Denver County, Colorado",864,787,29,758,77,18,59
"453","1500000US080310120011","080310120011","Block Group 1, Census Tract 120.01, Denver County, Colorado",1435,1313,129,1184,122,6,116
"454","1500000US080310120012","080310120012","Block Group 2, Census Tract 120.01, Denver County, Colorado",651,607,12,595,44,0,44
"455","1500000US080310120101","080310120101","Block Group 1, Census Tract 120.10, Denver County, Colorado",1967,1769,100,1669,198,0,198
"456","1500000US080310120102","080310120102","Block Group 2, Census Tract 120.10, Denver County, Colorado",1165,1104,0,1104,61,0,61
"457","1500000US080310120103","080310120103","Block Group 3, Census Tract 120.10, Denver County, Colorado",2022,1912,16,1896,110,11,99
"458","1500000US080310120141","080310120141","Block Group 1, Census Tract 120.14, Denver County, Colorado",1205,1142,38,1104,63,0,63
"459","1500000US080310120142","080310120142","Block Group 2, Census Tract 120.14, Denver County, Colorado",2708,2516,145,2371,192,17,175
"460","1500000US080310120143","080310120143","Block Group 3, Census Tract 120.14, Denver County, Colorado",907,817,0,817,90,0,90
"461","1500000US080310120144","080310120144","Block Group 4, Census Tract 120.14, Denver County, Colorado",1565,1511,50,1461,54,0,54
"462","1500000US080310153001","080310153001","Block Group 1, Census Tract 153, Denver County, Colorado",1529,1178,31,1147,351,6,345
"463","1500000US080310153002","080310153002","Block Group 2, Census Tract 153, Denver County, Colorado",1669,1396,27,1369,273,0,273
"464","1500000US080310153003","080310153003","Block Group 3, Census Tract 153, Denver County, Colorado",537,502,0,502,35,0,35
"465","1500000US080310154001","080310154001","Block Group 1, Census Tract 154, Denver County, Colorado",1264,1229,80,1149,35,0,35
"466","1500000US080310154002","080310154002","Block Group 2, Census Tract 154, Denver County, Colorado",1025,973,64,909,52,29,23
"467","1500000US080310154003","080310154003","Block Group 3, Census Tract 154, Denver County, Colorado",750,730,35,695,20,11,9
"468","1500000US080310154004","080310154004","Block Group 4, Census Tract 154, Denver County, Colorado",1363,1303,23,1280,60,10,50
"469","1500000US080310155001","080310155001","Block Group 1, Census Tract 155, Denver County, Colorado",1349,862,95,767,487,30,457
"470","1500000US080310155002","080310155002","Block Group 2, Census Tract 155, Denver County, Colorado",1391,1319,79,1240,72,22,50
"471","1500000US080310155003","080310155003","Block Group 3, Census Tract 155, Denver County, Colorado",801,720,39,681,81,0,81
"472","1500000US080310156001","080310156001","Block Group 1, Census Tract 156, Denver County, Colorado",3237,1906,187,1719,1331,240,1091
"473","1500000US080310156002","080310156002","Block Group 2, Census Tract 156, Denver County, Colorado",2004,1123,81,1042,881,25,856
"474","1500000US080310156003","080310156003","Block Group 3, Census Tract 156, Denver County, Colorado",1282,943,0,943,339,79,260
"475","1500000US080310156004","080310156004","Block Group 4, Census Tract 156, Denver County, Colorado",1402,1106,32,1074,296,0,296
"476","1500000US080310157001","080310157001","Block Group 1, Census Tract 157, Denver County, Colorado",1897,1631,107,1524,266,0,266
"477","1500000US080310157002","080310157002","Block Group 2, Census Tract 157, Denver County, Colorado",920,833,16,817,87,50,37
"478","1500000US080310157003","080310157003","Block Group 3, Census Tract 157, Denver County, Colorado",1184,1005,107,898,179,17,162
"479","1500000US080310157004","080310157004","Block Group 4, Census Tract 157, Denver County, Colorado",1648,1430,22,1408,218,0,218
"480","1500000US080319800001","080319800001","Block Group 1, Census Tract 9800, Denver County, Colorado",1449,1331,54,1277,118,0,118
"481","1500000US080319801001","080319801001","Block Group 1, Census Tract 9801, Denver County, Colorado",0,0,0,0,0,0,0
